1133111111
1        3
3111     1
3        1
3   1   33
1  31    3
1        1
3     1111
3        1
3111311311